66666666666666666666666
00000000000000000000666
22222200000000000000666
00000200022222200222636
00022200020000200200666
00020000020000200200666
00022222220000200200666
00000000000000200200646
00000000000000200220666
00002222002222200020666
00002002002000000020666
00002002002000000020656
00002002222000000020666
00002000000000000020666
02222000000000000020666
02000000000000000020666
02222222222222220020666
00000000000000020020666
00000000000000022220666
00000000000000000000666
00000000000000000000666
